22 22 22 22 22 22 22 22 22 22 22 22 22 22 22 22 22 22 22 22 22 22 22 22 22 22 22 22 22 22 22 22 22 22 22 22 22 22 22 22 22 22 22 22 22 22 22 22 22 22 
22 22 22 22 22 22 22 22 22 22 22 22 22 22 22 22 22 22 22 22 22 22 22 22 22 22 22 22 22 22 22 22 22 22 22 22 22 22 22 22 22 22 22 22 22 22 22 22 22 22 
22 22 22 22 22 22 22 22 22 22 22 22 22 22 22 22 22 22 22 22 22 22 22 22 22 22 22 22 22 22 22 22 22 22 22 22 22 22 22 22 22 22 22 22 22 22 22 22 22 22 
22 22 22 22 22 22 22 22 22 22 22 22 22 22 22 22 22 22 22 22 22 22 22 22 22 22 22 22 22 22 22 22 22 22 22 22 22 22 22 22 22 22 22 22 22 22 22 22 22 22 
22 22 22 22 22 22 22 22 22 22 22 22 22 22 22 22 22 22 22 22 22 22 22 22 22 22 22 22 22 22 22 22 22 22 22 22 22 22 22 22 22 22 22 22 22 22 22 22 22 22 
22 22 22 22 22 22 22 22 22 22 22 22 22 22 22 22 22 56 45 45 45 45 45 45 66 22 22 22 22 22 22 22 22 22 22 22 22 22 22 22 22 22 22 22 22 22 22 22 22 22 
22 22 22 22 22 22 22 22 22 22 22 22 22 22 22 22 22 15 53 52 51 54 53 52 16 22 22 22 22 22 22 22 22 22 22 22 22 22 22 22 22 22 22 22 22 22 22 22 22 22 
22 22 22 22 22 22 22 22 22 22 22 22 22 22 22 22 22 15 54 26 27 28 52 52 16 22 22 22 22 22 22 22 22 22 22 22 22 22 22 22 22 22 22 22 22 22 22 22 22 22 
22 22 22 22 22 22 22 22 22 22 22 22 22 22 22 22 22 15 52 32 33 35 52 52 16 22 22 22 22 22 22 22 22 22 22 22 22 22 22 22 22 22 22 22 22 22 22 22 22 22 
22 22 22 22 22 22 22 22 22 22 22 22 22 22 47 47 25 37 24 60 40 41 25 9 24 22 22 22 22 22 22 22 22 22 22 22 22 22 22 22 22 22 22 22 22 22 22 22 22 22 
22 22 22 22 22 22 22 22 22 22 22 22 22 22 47 47 2 71 8 24 60 50 18 30 8 24 47 22 22 22 22 22 22 22 22 22 22 22 22 22 22 22 22 22 22 22 22 22 22 22 
22 22 22 22 22 22 22 22 22 22 22 22 22 22 48 47 2 71 71 67 60 60 50 60 2 67 47 22 22 22 22 22 22 22 22 22 22 22 22 22 22 22 22 22 22 22 22 22 22 22 
22 22 22 22 22 22 22 22 22 22 22 22 22 22 47 47 2 71 71 67 42 60 60 50 2 67 47 48 47 22 22 22 22 22 22 22 22 22 22 22 22 22 22 22 22 22 22 22 22 22 
22 22 22 22 22 22 22 22 22 22 22 22 22 22 47 50 2 71 71 8 24 60 68 60 2 67 47 47 47 47 22 22 22 22 22 22 22 22 22 22 22 22 22 22 22 22 22 22 22 22 
22 22 22 22 22 22 22 22 22 22 22 22 22 22 47 47 2 71 71 71 8 24 60 60 2 8 24 60 60 47 47 47 22 22 22 22 22 22 22 22 22 22 22 22 22 22 22 22 22 22 
22 22 22 22 22 22 22 22 22 22 22 22 22 22 47 47 2 71 71 71 71 8 24 47 18 12 8 9 24 47 48 47 47 47 22 22 22 22 22 22 22 22 22 22 22 22 22 22 22 22 
22 22 22 22 22 22 22 22 22 22 22 22 22 22 47 47 2 71 71 71 71 71 67 47 68 18 12 71 8 24 60 60 60 47 47 47 22 22 22 22 22 22 22 22 22 22 22 22 22 22 
22 22 22 22 22 22 22 22 22 22 22 22 22 22 47 48 2 71 71 71 71 71 8 24 68 60 18 12 71 8 24 47 48 60 60 47 47 47 47 22 22 22 22 22 22 22 22 22 22 22 
22 22 22 22 22 22 22 22 22 22 22 22 22 22 47 47 2 71 71 71 71 71 71 8 24 68 47 2 71 71 8 9 9 9 9 9 9 24 48 47 22 22 22 22 22 22 22 22 22 22 
22 22 22 22 22 22 22 22 22 22 22 22 22 22 47 47 2 71 71 71 71 0 31 30 17 47 68 18 30 30 30 30 30 30 30 12 71 67 47 47 22 22 22 22 22 22 22 22 22 22 
22 22 22 22 22 22 22 22 22 22 22 22 22 22 50 47 2 71 71 71 0 17 47 47 47 47 47 47 47 47 47 60 60 60 60 2 71 8 24 47 22 22 22 22 22 22 22 22 22 22 
22 22 22 22 22 22 22 22 22 22 22 22 22 22 47 47 2 71 71 71 67 47 47 42 47 47 47 50 47 47 50 60 50 47 60 2 71 71 67 47 22 22 22 22 22 22 22 22 22 22 
22 22 22 22 22 22 22 22 22 22 22 22 22 22 47 47 2 71 71 71 67 47 47 47 47 47 60 60 60 60 60 60 60 60 60 2 71 71 67 48 22 22 22 22 22 22 22 22 22 22 
22 22 22 22 22 22 22 22 22 22 22 22 22 22 48 47 2 71 71 71 67 47 47 25 37 37 37 24 60 60 60 60 60 60 60 2 71 71 67 47 22 22 22 22 22 22 22 22 22 22 
22 22 22 22 22 22 22 22 22 22 22 22 22 22 47 47 2 71 71 71 67 47 47 2 71 71 71 67 60 60 60 60 60 42 60 2 71 71 67 47 22 22 22 22 22 22 22 22 22 22 
22 22 22 22 22 22 22 22 22 22 22 22 22 22 47 47 2 71 71 71 67 47 47 2 71 71 71 67 60 44 60 60 60 60 60 2 0 1 17 47 22 22 22 22 22 22 22 22 22 22 
22 22 22 22 22 22 22 22 22 22 22 22 22 22 47 47 2 71 71 71 67 47 47 2 71 71 71 67 60 60 60 60 60 60 60 2 67 47 48 47 22 22 22 22 22 22 22 22 22 22 
22 22 22 22 22 22 22 22 22 22 22 22 22 22 50 47 2 71 71 71 67 47 42 2 71 71 71 67 60 47 60 60 60 60 25 10 67 47 47 22 22 22 22 22 22 22 22 22 22 22 
22 22 22 22 22 22 22 22 22 22 22 22 22 22 47 50 18 12 71 71 67 47 47 18 30 30 30 17 47 47 60 47 25 9 10 71 67 47 75 22 22 22 22 22 22 22 22 22 22 22 
22 22 22 22 22 22 22 22 22 22 22 22 22 22 47 47 47 2 71 71 67 68 47 47 47 47 47 50 47 60 42 47 18 12 71 71 67 47 16 22 22 22 22 22 22 22 22 22 22 22 
22 22 22 22 22 22 22 22 22 22 22 22 22 22 47 47 47 2 71 71 67 68 68 68 47 47 47 47 47 47 47 47 47 18 12 71 67 47 16 22 22 22 22 22 22 22 22 22 22 22 
22 22 22 22 22 22 22 22 22 22 22 22 22 22 47 48 47 2 71 71 8 9 9 9 9 9 9 9 9 9 24 47 47 47 2 71 67 47 16 22 22 22 22 22 22 22 22 22 22 22 
22 22 22 22 22 22 22 22 22 22 22 22 22 22 47 47 47 2 71 71 71 71 71 71 71 71 71 71 71 71 67 47 47 47 2 71 67 48 16 22 22 22 22 22 22 22 22 22 22 22 
22 22 22 22 22 22 22 22 22 22 22 22 22 22 47 50 47 2 71 71 71 71 71 71 71 71 71 71 71 71 67 47 47 47 2 71 67 47 16 22 22 22 22 22 22 22 22 22 22 22 
22 22 22 22 22 22 22 22 22 22 22 22 22 22 50 47 47 18 12 71 71 71 71 71 71 30 30 71 71 71 67 47 42 47 2 71 67 47 16 22 22 22 22 22 22 22 22 22 22 22 
22 22 22 22 22 22 22 22 22 22 22 22 22 22 47 47 47 47 18 12 71 71 71 71 17 47 47 18 71 71 67 47 47 47 2 71 67 47 16 22 22 22 22 22 22 22 22 22 22 22 
22 22 22 22 22 22 22 22 22 22 22 22 22 22 47 47 48 47 47 2 71 71 71 67 47 47 47 25 71 71 67 47 47 47 2 71 67 47 16 22 22 22 22 22 22 22 22 22 22 22 
22 22 22 22 22 22 22 22 22 22 22 22 22 22 47 47 47 47 50 18 12 71 71 8 24 47 47 2 71 71 67 50 47 42 2 71 67 47 16 22 22 22 22 22 22 22 22 22 22 22 
22 22 22 22 22 22 22 22 22 22 22 22 22 22 22 47 47 47 47 47 18 12 71 71 8 36 9 10 71 71 67 47 47 47 2 71 67 47 16 22 22 22 22 22 22 22 22 22 22 22 
22 22 22 22 22 22 22 22 22 22 22 22 22 22 22 60 47 50 47 47 47 2 71 71 71 71 71 71 71 71 67 47 47 47 2 71 67 48 16 22 22 22 22 22 22 22 22 22 22 22 
22 22 22 22 22 22 22 22 22 22 22 22 22 22 22 22 60 47 47 48 60 2 71 71 71 71 71 71 0 29 17 47 50 47 2 71 67 47 7 22 22 22 22 22 22 22 22 22 22 22 
22 22 22 22 22 22 22 22 22 22 22 22 22 22 22 22 22 47 47 47 47 2 71 71 71 71 71 71 67 60 47 43 47 47 2 71 67 47 7 22 22 22 22 22 22 22 22 22 22 22 
22 22 22 22 22 22 22 22 22 22 22 22 22 22 22 22 22 47 50 25 9 10 71 71 71 71 71 71 67 60 42 60 50 47 2 71 67 47 7 22 22 22 22 22 22 22 22 22 22 22 
22 22 22 22 22 22 22 22 22 22 22 22 22 22 22 22 22 47 47 2 0 31 31 31 31 12 71 71 67 60 60 60 50 60 2 71 67 47 7 22 22 22 22 22 22 22 22 22 22 22 
22 22 22 22 22 22 22 22 22 22 22 22 22 22 22 22 22 47 47 2 67 52 52 52 52 2 71 71 67 42 60 60 60 60 2 71 67 47 7 22 22 22 22 22 22 22 22 22 22 22 
22 22 22 22 22 22 22 22 22 22 22 22 22 22 22 22 22 47 47 2 67 3 4 5 54 2 71 71 67 60 60 60 42 60 2 71 67 68 7 22 22 22 22 22 22 22 22 22 22 22 
22 22 22 22 22 22 22 22 22 22 22 22 22 22 22 22 22 47 48 2 67 11 13 14 53 18 29 29 17 47 50 60 43 60 2 71 67 48 7 22 22 22 22 22 22 22 22 22 22 22 
22 22 22 22 22 22 22 22 22 22 22 22 22 22 22 22 22 47 60 2 67 39 68 41 60 47 47 50 60 68 60 60 60 60 2 71 67 60 7 22 22 22 22 22 22 22 22 22 22 22 
22 22 22 22 22 22 22 22 22 22 22 22 22 22 22 22 22 25 37 10 8 37 37 37 37 37 37 37 37 37 37 37 37 37 10 71 8 37 70 22 22 22 22 22 22 22 22 22 22 22 
22 22 22 22 22 22 22 22 22 22 22 22 22 22 22 22 22 2 71 71 71 71 71 71 71 71 71 71 71 71 71 71 71 71 71 71 71 71 70 22 22 22 22 22 22 22 22 22 22 22 
