21 21 21 22 21 21 5 9 2 23 24 25 2 2 2 2 19 19 19 19 19 19 19 20 20 20 20 19 19 19 19 19 19 19 2 2 2 2 2 23 24 25 2 14 13 5 21 21 21 21 
21 21 21 22 21 21 5 9 2 26 21 27 2 2 2 19 19 19 19 19 19 19 20 20 35 35 20 20 19 19 19 19 19 19 19 2 2 2 2 26 21 27 2 10 5 5 21 21 21 21 
21 21 21 22 21 21 5 9 2 28 29 30 2 2 19 19 19 19 19 19 19 20 20 35 35 35 35 20 20 19 19 19 19 19 19 19 2 2 3 28 29 30 2 10 5 5 21 21 21 21 
21 21 21 22 21 21 5 9 2 2 2 2 2 19 19 19 19 19 19 19 20 20 35 35 35 35 35 35 20 20 19 19 19 19 19 19 19 2 3 3 3 3 2 10 5 5 21 21 21 21 
21 21 21 22 21 21 5 11 19 19 19 19 19 19 19 19 19 19 19 19 20 20 35 35 35 35 35 35 20 20 19 19 19 19 19 19 19 19 19 19 19 19 19 10 5 5 21 21 22 22 
21 21 22 22 21 21 5 5 9 19 19 19 19 19 19 19 19 19 19 19 3 3 3 10 5 5 9 2 2 2 19 19 19 19 19 19 19 19 19 19 19 19 2 10 5 21 21 21 21 21 
21 22 22 21 21 21 21 5 9 19 19 19 19 19 19 19 19 19 19 19 2 2 2 10 5 5 9 2 2 2 19 19 19 19 19 19 19 19 19 19 19 19 14 13 5 21 21 21 21 21 
21 22 22 22 21 21 21 5 9 19 19 19 19 19 19 19 19 19 19 19 2 2 2 10 5 5 9 2 2 2 19 19 19 19 19 19 19 19 19 19 19 19 10 5 5 21 22 22 21 21 
21 21 22 22 21 21 21 5 9 19 19 19 19 19 19 19 19 19 19 19 2 2 2 10 5 5 9 2 2 2 19 19 19 19 19 19 19 19 19 19 19 19 10 5 21 21 22 21 21 21 
21 21 22 22 21 21 21 5 9 19 19 19 19 19 19 19 19 19 19 19 3 3 3 10 5 5 9 2 2 2 19 19 19 19 19 19 19 19 19 19 19 19 10 5 21 21 21 21 21 21 
21 21 22 22 22 21 21 5 11 15 2 2 2 19 19 19 19 2 2 2 2 2 2 10 5 5 9 2 2 2 2 2 2 2 2 2 2 19 2 2 2 2 10 5 21 22 21 21 21 21 
21 21 21 21 22 22 21 5 5 2 2 2 2 19 19 19 19 14 12 12 12 12 12 13 5 5 9 2 2 3 3 3 3 3 3 2 2 19 2 2 2 2 10 5 21 22 22 22 21 21 
21 21 21 21 21 22 22 21 5 11 15 2 2 19 19 19 19 10 5 5 5 5 5 5 5 5 11 12 12 12 12 12 12 15 2 3 2 19 19 2 2 2 10 5 21 21 21 22 21 21 
21 21 21 21 21 21 22 21 5 5 9 2 2 19 19 19 19 10 5 5 5 5 5 5 5 5 5 5 5 5 5 5 5 9 2 2 3 2 19 19 2 2 10 5 21 21 22 22 21 21 
21 21 21 21 21 22 22 21 21 5 9 2 2 19 19 19 19 10 5 5 19 19 19 19 5 5 5 5 5 5 5 5 5 9 2 2 2 3 2 19 2 2 10 5 21 21 21 22 21 21 
21 21 21 21 22 22 21 21 21 5 9 2 19 19 19 19 19 10 5 5 19 19 19 19 19 19 19 19 19 19 19 5 5 9 2 2 2 19 19 19 3 2 10 5 21 21 22 22 21 21 
21 21 21 22 22 21 21 21 21 5 9 19 19 19 19 2 2 10 5 5 9 2 2 19 19 19 19 19 19 19 19 5 5 9 2 2 2 19 19 19 3 2 10 5 21 22 22 21 21 21 
21 21 21 21 21 21 21 5 5 5 9 19 19 19 2 2 2 10 5 5 9 2 2 19 19 19 19 19 19 19 19 5 5 9 3 3 2 19 2 2 3 2 10 5 21 22 21 21 21 21 
21 21 21 21 21 21 5 5 6 7 17 19 19 2 2 2 2 10 5 5 9 2 2 19 19 19 19 19 19 19 19 5 5 9 2 2 2 19 19 2 3 14 13 5 21 21 22 21 21 21 
21 21 21 21 21 21 5 5 9 2 19 19 2 2 2 2 2 10 5 5 9 2 2 19 19 19 19 19 19 19 19 5 5 9 2 2 19 19 19 2 14 13 5 5 21 21 22 22 22 21 
21 21 21 21 21 21 5 5 9 2 19 19 2 2 2 2 2 10 5 5 9 2 2 19 19 19 19 19 19 19 19 5 5 9 2 2 19 2 19 2 10 5 5 21 21 21 21 21 22 21 
21 21 21 21 21 21 21 5 11 15 19 19 2 2 2 23 24 24 25 5 9 12 12 19 19 19 19 19 19 19 19 5 5 9 2 2 19 2 19 14 13 5 21 21 21 21 21 21 21 21 
21 21 21 21 21 21 21 5 5 9 19 19 2 2 2 26 21 21 27 5 5 5 5 5 5 5 5 5 5 5 5 5 5 9 2 2 19 19 2 10 5 5 21 21 21 21 22 21 21 21 
21 21 21 21 21 21 21 21 5 9 19 19 2 2 2 28 29 29 30 5 5 5 5 5 5 5 5 5 5 5 5 5 5 9 2 2 19 2 2 10 5 21 21 21 22 22 22 21 21 21 
21 21 21 21 22 21 21 5 5 9 19 19 2 2 2 2 2 3 16 7 7 7 7 19 19 19 19 19 7 7 8 5 5 9 3 3 19 19 2 10 5 21 21 22 22 21 21 22 21 21 
21 21 21 21 22 21 5 5 6 17 19 19 2 2 2 2 2 2 2 2 2 2 19 19 19 19 19 19 19 19 10 5 5 9 2 2 2 19 2 10 5 21 21 21 21 21 22 22 21 21 
21 21 21 21 22 21 5 6 2 19 19 19 19 2 2 2 2 19 2 2 19 19 19 19 19 19 19 19 19 19 10 5 5 9 2 2 2 19 2 10 5 5 21 21 21 21 22 21 21 21 
21 21 21 21 22 22 5 9 19 19 19 19 19 19 19 19 19 19 19 19 19 19 19 19 19 19 19 19 19 19 10 5 5 9 2 2 2 19 19 16 8 5 21 21 21 22 21 21 21 21 
21 21 21 22 22 22 5 9 19 19 19 19 19 19 19 19 19 19 19 19 19 19 19 19 19 19 19 19 19 19 10 5 5 9 3 2 2 19 19 2 10 5 21 22 22 22 21 21 21 21 
21 21 21 22 21 21 5 9 19 19 19 19 19 19 19 19 19 19 19 19 19 19 19 19 19 19 19 19 19 19 10 5 5 9 2 2 2 19 2 2 10 5 21 21 22 22 21 21 21 21 
21 21 22 22 21 21 5 9 19 3 19 19 19 19 19 19 19 19 19 19 3 3 3 3 3 19 19 19 19 19 10 5 5 9 2 2 2 2 19 3 10 5 21 21 21 22 22 21 21 21 
21 21 22 21 21 21 5 9 19 19 19 19 19 19 19 19 19 19 19 19 3 23 24 25 3 19 19 19 19 19 10 5 5 9 2 2 19 2 19 3 10 5 21 21 21 21 22 22 21 21 
21 21 22 21 21 21 5 9 19 19 19 19 19 19 19 19 19 19 19 19 3 26 21 27 3 19 19 19 19 19 10 5 5 9 2 2 19 2 19 2 13 5 21 21 21 21 21 21 21 21 
21 21 22 21 21 21 5 9 19 19 19 19 19 19 19 19 19 19 19 19 3 28 29 30 3 19 19 19 19 19 10 5 5 9 2 2 19 19 14 13 5 5 21 21 21 21 21 21 21 21 
21 21 22 21 21 5 5 9 19 19 19 19 19 19 19 19 19 19 19 19 3 3 3 3 3 19 19 19 19 19 10 5 5 9 2 2 19 2 13 5 5 21 21 21 21 21 21 22 22 21 
21 21 22 21 21 5 19 19 19 19 19 19 19 19 19 19 19 19 19 19 19 19 19 19 19 19 19 19 19 19 10 5 5 9 2 19 19 10 5 5 21 22 21 21 21 21 22 22 21 21 
21 21 21 21 5 5 9 19 19 19 19 19 19 19 19 19 19 19 19 19 19 19 19 19 19 19 19 19 19 19 10 5 5 9 2 19 19 10 5 21 21 22 22 21 21 21 21 21 21 21 
21 21 21 21 5 5 11 12 12 12 12 12 12 12 12 12 12 12 12 12 12 12 12 12 12 12 12 12 12 12 13 5 5 11 12 12 12 13 5 21 21 21 21 22 22 21 21 21 21 21 
21 21 21 21 21 5 5 5 5 5 5 5 5 5 5 5 5 5 5 5 5 5 5 5 5 5 5 5 5 5 5 5 5 5 5 5 5 5 5 5 21 21 21 21 22 22 22 21 21 21 
21 21 21 21 21 5 5 5 5 5 5 5 5 5 5 5 5 5 5 5 5 5 5 5 5 5 5 5 5 5 5 5 5 5 5 5 5 5 5 5 5 21 21 21 21 21 22 22 21 21 
21 22 22 22 21 5 5 5 5 5 5 5 5 5 5 5 5 5 5 5 5 5 5 5 5 5 5 5 5 5 5 5 5 5 5 5 5 5 5 5 5 21 21 22 22 22 21 21 21 21 
21 22 22 21 21 21 5 5 5 5 5 5 5 5 5 5 5 5 5 5 5 5 5 5 5 5 5 5 5 5 5 5 5 5 5 5 5 5 5 5 5 21 21 21 22 22 22 22 22 21 
21 21 21 22 22 21 5 5 5 5 5 5 5 5 5 5 5 5 5 5 5 5 5 5 5 5 5 5 5 5 5 5 5 5 5 5 5 5 5 5 5 21 21 21 21 21 21 21 21 21 
21 21 21 21 22 21 21 21 21 5 5 5 5 5 5 5 5 5 5 5 5 5 5 5 5 5 5 5 5 5 5 5 5 5 5 5 5 5 5 5 21 21 21 21 21 22 22 22 21 21 
21 21 21 21 21 21 21 21 21 21 21 21 21 21 21 21 21 21 21 21 21 21 21 5 5 5 5 5 5 5 5 5 5 5 5 5 5 5 5 5 21 21 21 22 22 22 22 21 21 21 
21 21 21 21 21 21 21 21 21 21 21 21 21 22 22 21 21 21 21 21 21 21 21 21 21 21 21 21 21 21 5 5 5 5 5 5 5 5 5 21 21 21 22 22 21 21 21 21 21 21 
21 21 21 22 22 22 22 22 22 22 22 21 21 21 22 21 21 21 21 22 22 21 21 21 21 21 21 21 22 21 21 21 21 21 21 21 21 21 21 21 21 21 22 22 22 22 22 22 21 21 
21 21 21 21 21 21 21 21 21 22 22 21 21 21 22 21 21 21 22 22 21 21 22 22 21 22 22 22 22 22 21 22 22 21 21 21 21 21 22 22 22 22 22 22 21 21 21 21 21 21 
21 21 21 21 21 21 21 21 21 22 22 21 21 21 21 22 21 21 21 22 22 22 22 22 22 22 21 21 21 21 22 22 22 22 22 22 21 21 21 21 21 21 21 21 21 21 21 21 21 21 
21 21 21 21 21 21 21 21 21 21 21 21 21 21 21 22 21 21 21 21 21 21 21 21 21 21 21 21 21 21 21 21 21 21 21 21 21 21 21 21 21 21 21 21 21 21 21 21 21 21 
