21 21 21 21 21 21 21 21 21 21 21 21 21 21 21 21 21 21 21 21 21 21 21 21 21 21 21 21 21 21 21 21 21 21 21 21 21 21 21 21 21 21 21 21 21 21 21 21 21 21 
21 21 21 21 21 21 21 21 21 21 21 21 21 21 21 21 21 21 21 21 21 21 21 21 21 21 21 21 21 21 21 21 21 21 21 21 21 21 21 21 21 21 21 21 21 21 21 21 21 21 
21 21 21 21 21 21 21 21 21 21 21 21 21 21 21 21 21 21 21 21 21 21 21 21 21 21 21 21 21 21 21 21 21 21 21 21 21 21 21 21 21 21 21 21 21 21 21 21 21 21 
21 21 21 21 21 21 21 21 21 21 21 21 21 21 21 21 21 21 21 21 21 21 21 21 21 21 21 21 21 21 21 21 21 21 21 21 21 21 21 21 21 21 21 21 21 21 21 21 21 21 
21 21 21 21 21 21 21 21 21 21 21 21 21 21 21 21 21 21 21 21 21 21 21 21 21 21 21 21 21 21 21 21 21 21 21 21 21 21 21 21 21 21 21 21 21 21 21 21 21 21 
21 21 21 21 21 21 21 21 21 21 21 21 21 21 21 21 5 5 5 5 5 5 5 5 5 5 21 21 21 21 21 21 21 21 21 21 21 21 21 21 21 21 21 21 21 21 21 21 21 21 
21 21 21 21 21 21 21 21 21 21 21 21 21 21 21 21 5 2 2 2 2 3 2 2 2 5 5 5 5 5 21 21 21 21 21 21 21 21 21 21 21 21 21 21 21 21 21 21 21 21 
21 21 21 21 21 21 21 21 21 21 21 21 21 21 21 21 5 2 2 2 2 3 3 3 2 2 2 2 2 5 5 5 21 21 21 21 21 21 21 21 21 21 21 21 21 21 21 21 21 21 
21 21 21 21 21 21 21 21 21 21 21 21 21 21 21 21 5 2 2 2 23 24 25 2 3 3 3 2 2 2 2 5 5 21 21 21 21 21 21 21 21 21 21 21 21 21 21 21 21 21 
21 21 21 21 21 21 21 21 21 21 21 21 21 21 21 5 5 2 2 2 26 21 27 2 2 2 3 3 2 2 2 2 5 21 21 21 21 21 21 21 21 21 21 21 21 21 21 21 21 21 
21 21 21 21 21 21 21 21 21 21 21 21 21 21 5 5 2 2 2 3 28 29 30 2 2 2 2 2 2 2 2 2 5 5 5 21 21 21 21 21 21 21 21 21 21 21 21 21 21 21 
21 21 21 21 21 21 21 21 21 21 21 21 21 5 5 2 2 2 3 3 2 2 2 2 2 2 3 3 23 24 25 2 2 2 5 5 21 21 21 21 21 21 21 21 21 21 21 21 21 21 
21 21 21 21 21 21 21 21 21 21 21 5 5 5 2 2 2 2 3 2 2 2 2 3 3 3 3 2 26 21 27 2 2 2 2 5 5 5 21 21 21 21 21 21 21 21 21 21 21 21 
21 21 21 21 21 21 21 21 21 21 5 5 2 2 2 2 2 2 2 2 2 2 2 2 2 2 2 2 28 29 30 2 2 2 2 19 19 5 5 21 21 21 21 21 21 21 21 21 21 21 
21 21 21 21 21 21 21 21 21 21 5 2 2 2 2 2 2 2 2 2 2 2 2 2 2 2 2 2 2 2 3 3 2 2 2 19 19 19 5 5 21 21 21 21 21 21 21 21 21 21 
21 21 21 21 21 21 21 21 21 21 5 2 2 14 12 12 12 12 12 12 12 12 12 12 12 12 12 15 2 2 2 3 3 2 2 19 19 19 19 5 21 21 21 21 21 21 21 21 21 21 
21 21 21 21 21 21 21 21 21 21 5 5 2 10 5 5 5 5 5 5 5 5 5 5 5 5 5 9 2 2 2 3 2 2 2 19 19 19 19 5 21 21 21 21 21 21 21 21 21 21 
21 21 21 21 21 21 21 21 21 21 21 5 2 10 5 5 5 5 5 5 5 5 5 5 5 5 5 9 2 2 2 3 2 2 2 19 19 19 19 5 21 21 21 21 21 21 21 21 21 21 
21 21 21 21 21 21 21 21 21 21 21 5 2 10 5 5 6 7 7 7 7 7 7 7 8 5 5 9 2 2 2 3 3 3 2 19 19 19 5 5 21 21 21 21 21 21 21 21 21 21 
21 21 21 21 21 21 21 21 21 21 21 5 2 10 5 5 9 2 2 2 3 3 3 2 10 5 5 9 2 2 2 2 3 3 2 19 19 19 26 21 21 21 21 21 21 21 21 21 21 21 
21 21 21 21 21 21 21 21 21 21 5 5 2 10 5 5 9 2 3 3 2 2 3 2 10 5 5 9 2 3 3 3 3 2 2 19 23 24 34 22 22 22 22 21 21 21 21 21 21 21 
21 21 21 21 21 21 21 21 21 5 5 2 2 10 5 5 9 2 2 2 3 3 3 2 10 5 5 9 2 3 3 2 2 2 2 23 34 21 21 22 22 22 22 21 21 21 21 21 21 21 
21 21 21 21 21 21 21 21 5 5 2 2 2 10 5 5 9 2 2 2 2 2 2 2 10 5 5 9 2 2 2 2 2 2 23 34 21 21 21 22 22 22 22 22 22 21 21 21 21 21 
21 21 21 21 21 21 21 21 5 2 19 19 19 19 5 5 19 19 19 19 2 2 2 2 10 5 5 9 3 3 2 2 3 23 34 21 21 22 22 22 22 22 22 22 22 21 21 21 21 21 
21 21 21 21 21 21 21 21 5 2 19 2 4 10 5 9 2 4 2 19 2 2 2 2 10 5 5 9 2 2 2 3 23 34 21 22 22 22 22 22 22 22 21 21 21 21 21 21 21 21 
21 21 21 21 21 21 21 31 30 19 19 2 2 10 5 9 3 2 2 19 2 2 2 2 10 5 5 11 2 2 23 24 34 21 21 22 22 22 22 22 21 22 21 21 21 21 21 21 21 21 
21 21 21 21 21 21 21 27 19 19 19 2 2 10 5 23 24 25 2 19 2 2 2 2 10 5 5 5 5 5 26 21 22 22 22 22 22 22 22 22 22 21 21 21 21 21 21 21 21 21 
21 21 21 21 21 21 21 27 19 19 19 12 12 13 5 28 29 30 2 19 2 2 2 2 10 5 5 5 5 5 26 22 22 22 22 22 22 22 22 22 22 21 21 21 21 21 21 21 21 21 
21 21 21 21 21 21 21 27 5 5 5 5 5 5 5 9 2 2 2 19 2 2 2 2 16 7 7 7 7 7 28 29 32 22 22 22 22 22 22 22 21 21 21 21 21 21 21 21 21 21 
21 21 21 21 21 21 21 27 19 19 19 7 7 8 5 11 15 2 2 19 2 2 2 2 2 2 2 2 2 2 2 3 28 32 21 22 22 22 22 22 22 21 21 21 21 21 21 21 21 21 
21 21 21 21 21 21 31 30 19 19 19 19 19 19 5 5 11 19 19 19 19 19 19 19 19 19 19 19 19 19 19 19 3 28 29 29 32 21 22 22 22 22 22 22 22 22 21 21 21 21 
21 21 21 21 21 21 27 19 19 2 2 2 2 19 5 5 5 5 5 5 5 5 5 5 5 5 5 5 5 5 5 19 2 2 3 3 28 32 21 22 22 22 22 22 22 22 21 21 21 21 
21 21 21 21 21 21 27 19 2 2 2 2 2 19 5 5 5 5 5 5 5 5 5 5 5 5 5 5 5 5 5 19 2 2 2 2 3 28 32 21 21 21 21 21 22 22 21 21 21 21 
21 21 21 21 21 21 27 19 2 2 2 2 2 19 19 19 19 19 19 5 5 19 19 19 19 19 19 19 19 5 5 19 2 2 2 2 2 19 28 32 21 21 21 21 21 22 22 21 21 21 
21 21 21 21 21 21 33 25 2 2 2 2 2 19 2 2 2 2 10 5 5 9 2 2 2 2 2 2 19 5 5 19 2 3 3 2 3 19 19 28 32 22 21 21 21 21 21 21 21 21 
21 21 21 21 21 21 21 27 2 2 2 2 2 19 2 3 3 2 10 5 5 9 3 2 2 2 2 2 19 5 5 19 2 2 3 2 3 19 19 19 26 22 21 21 21 21 21 21 21 21 
21 21 21 21 21 21 21 21 25 2 2 2 2 19 2 2 2 2 10 5 5 9 3 3 3 3 2 2 19 5 5 19 2 2 2 2 3 19 19 19 5 22 21 21 21 21 21 21 21 21 
21 21 21 21 21 21 21 21 5 5 2 2 2 19 2 2 2 2 10 5 5 11 12 12 12 12 12 12 19 5 5 19 2 2 3 3 2 19 19 19 5 21 21 21 21 21 21 21 21 21 
21 21 21 21 21 21 21 21 21 5 5 2 2 19 2 2 3 3 10 5 5 5 5 5 5 5 5 5 5 5 5 19 2 2 3 2 2 19 19 19 5 21 21 21 21 21 21 21 21 21 
21 21 21 21 21 21 21 21 21 21 5 5 2 19 2 2 3 3 10 5 5 5 5 5 5 5 5 5 5 5 5 19 2 2 3 2 2 19 19 19 5 21 21 21 21 21 21 21 21 21 
21 21 21 21 21 21 21 21 21 21 21 5 5 19 3 3 3 3 16 7 7 7 7 7 7 7 7 7 19 5 5 19 2 2 3 3 2 19 19 19 5 5 21 21 21 21 21 21 21 21 
21 21 21 21 21 21 21 21 21 21 21 21 5 19 2 2 2 2 2 2 2 2 2 2 2 2 2 2 19 5 5 19 2 2 2 3 2 19 19 19 19 5 21 21 21 21 21 21 21 21 
21 21 21 21 21 21 21 21 21 21 21 5 5 19 19 19 19 19 19 19 19 19 19 19 19 19 19 19 19 5 5 19 19 2 2 2 2 2 2 2 2 5 21 21 21 21 21 21 21 21 
21 21 21 21 21 21 21 21 21 5 5 5 2 2 2 2 2 2 2 20 20 20 20 2 2 2 2 2 19 5 5 19 19 19 19 19 19 2 3 2 2 5 5 21 21 21 21 21 21 21 
21 21 21 21 21 21 21 21 21 5 2 2 2 3 2 2 2 2 20 20 35 35 20 20 2 2 2 2 19 5 5 5 5 5 5 5 19 2 2 3 2 2 5 21 21 21 21 21 21 21 
21 21 21 21 21 21 21 21 5 5 2 2 3 3 2 2 2 20 20 35 35 35 35 20 20 2 2 2 19 5 5 5 5 5 5 5 19 2 2 3 2 2 5 5 21 21 21 21 21 21 
21 21 21 21 21 21 21 5 5 2 2 3 3 2 2 2 2 20 35 35 35 35 35 35 20 2 2 2 19 19 19 19 19 19 5 5 19 2 2 3 2 2 2 5 21 21 21 21 21 21 
21 21 21 21 21 21 21 5 2 2 2 2 3 3 3 3 2 19 19 19 5 5 19 19 19 19 19 19 19 19 19 19 19 19 5 5 19 2 2 3 2 2 2 5 21 21 21 21 21 21 
21 21 21 21 21 21 5 5 2 2 2 2 2 2 3 3 2 19 19 19 5 5 5 5 5 5 5 5 5 5 5 5 5 5 5 5 19 2 2 3 3 2 2 5 21 21 21 21 21 21 
21 21 21 21 21 21 5 2 2 2 2 2 2 2 2 2 2 19 19 19 19 19 19 19 19 19 19 19 19 19 19 19 19 19 19 19 19 2 2 2 2 2 2 5 21 21 21 21 21 21 
